分披萨 - 递归，贪心思想
查找单入口区域 - 单独记录这一片区域有几个入口
流浪地球 - bfs
小明减肥 -
压缩日志查询 - 区间交集，开始和结束时间
流量波峰
数字序列比大小
精准核酸检测
符合条件的元组个数 - 回溯算法，组合
AI面板识别 - 优先队列
最长的密码 - 暴力算法可能会超时
猜数字 - 数据量小，枚举所有值进行匹配
计算误码率 -
增强的strstr - 正则表达式，要复习
相对开音节 - 复习一下正则
字符串计数匹配 - 具体逻辑有点绕
特异性双端队列
贪心的商人 - 记住计算利润怎么算就行，和前一天进行比较
出错的或电路 - 记住结论吧
亲子游戏 - 层级BFS
取出尽可能少的球 - 二分法，计算long middle = left +  (right - left + 1) / 2;向上取整
WonderLand - 动态规划，记一下吧
任务最优调度 - 数学原理，记一下吧
统计差异值大于相似值二元组个数 - 记忆，异或、与关系
网格红绿灯最短路径 - 最短路径问题，
高效的任务规划 - 贪心，所有配置时间 + 最大的执行时间

C卷
对称美学
分苹果
最少有多少个小朋友